{
    "size":{
        "x":10,
        "y":10
    },
    "ground":[
        [ 0,0,0,0,0,0,0,0,0,0 ],
        [ 0,0,0,0,0,0,0,0,0,0 ],
        [ 0,0,0,1,1,1,0,0,0,0 ],
        [ 0,0,0,1,1,1,1,0,0,0 ],
        [ 0,0,0,0,1,1,1,1,0,0 ],
        [ 0,0,0,1,1,1,1,1,0,0 ],
        [ 0,0,0,1,1,1,1,0,0,0 ],
        [ 0,0,0,1,1,1,0,0,0,0 ],
        [ 0,0,0,0,0,0,0,0,0,0 ],
        [ 0,0,0,0,0,0,0,0,0,0 ]
    ],
    "object":[
        [ 0,0,0,0,2,3,0,0,0,0 ],
        [ 0,0,0,0,2,3,0,0,0,0 ],
        [ 0,0,0,0,2,3,0,0,0,0 ],
        [ 0,0,0,0,2,3,0,0,0,0 ],
        [ 0,0,0,0,2,3,0,0,0,0 ],
        [ 0,0,0,0,2,3,0,0,0,0 ],
        [ 0,0,0,0,2,3,0,0,0,0 ],
        [ 0,0,0,0,2,3,0,0,0,0 ],
        [ 0,0,0,0,2,3,0,0,0,0 ],
        [ 0,0,0,0,2,3,0,0,0,0 ]
    ]
}